2936
10 10
9 1
11,5,9,7,13,13,9,1,4,13
13,12,12,13,8,2,6,12,10,6
8,2,0,0,2,7,13,12,13,13
14,11,6,8,5,11,0,6,10,4
13,13,13,14,8,7,10,3,3,6
8,2,4,11,0,5,13,9,5,13
8,7,8,3,6,10,0,6,12,12
12,11,4,13,13,11,6,13,8,6
12,9,6,8,4,9,3,4,8,7
12,10,3,6,10,2,7,14,10,7
