                 V
+-+-+-+-+-+-+-+-+ +-+
|   |   | | |     | |
+-+ + +-+ + + + + + +
| | | | |     | |   |
+ + + + + +-+-+ +-+-+
|           | | | | |
+ +-+ + +-+-+ + + + +
| |   |   |     |   |
+-+-+-+ + +-+ +-+-+ +
| | | | |   |       |
+ + + +-+ +-+-+-+-+-+
|     |     | |   | |
+ +-+ +-+ + + + + + +
|   |     |     | | |
+ +-+ +-+-+-+ +-+ + +
| |   | | |   | |   |
+ +-+ + + +-+-+ + +-+
| |   |   |     |   |
+ + +-+ + + +-+ + +-+
| |     |     | |   |
+ +-+-+-+-+-+-+-+-+-+
 V
