                             V
+-+-+-+-+-+-+-+-+-+-+-+-+-+-+ +
| | | |     |           |   | |
+ + + +-+-+ +-+ + +-+-+ + +-+ +
|         | | | |   |     |   |
+-+ +-+-+ + + + +-+ +-+-+-+ + +
|   |       |   | |   |     | |
+-+-+ +-+-+ +-+-+ +-+ +-+-+-+ +
| |   |           |   |       |
+ +-+ + +-+-+-+ +-+-+ + +-+-+ +
| |   |       |   | |     |   |
+ + +-+-+ +-+-+ + + +-+ +-+-+ +
|   | | | | | | |       |     |
+ +-+ + +-+ + +-+ +-+-+-+ +-+ +
|   |           |   |   |   | |
+ + + +-+ +-+ +-+ +-+-+ +-+ +-+
| |   |     |   | | |         |
+ +-+-+ +-+-+-+ + + + + +-+-+-+
| | |       |   | | | |       |
+ + +-+-+-+-+-+ +-+ +-+ +-+-+ +
| | |   | |   |     | | |     |
+ + +-+ + + +-+-+ +-+ +-+-+-+ +
| |           |     |     | | |
+-+-+ +-+-+-+-+ +-+-+-+ +-+ + +
| |         |     |     |     |
+ + +-+-+ +-+-+-+ + + + +-+ + +
| | | |   | |     | | | | | | |
+ + + + + + + +-+-+-+ +-+ + +-+
|     | |       | |     |     |
+ + +-+ +-+ +-+-+ + +-+ + +-+-+
| |   |   | |         |       |
+-+-+-+ +-+-+-+-+-+-+-+-+-+-+-+
       V
