                   V
+-+-+-+-+-+-+-+-+-+ +-+-+-+-+-+-+-+-+-+-+
| |     | |         |     |             |
+ + + + + +-+-+ +-+ + +-+ + +-+ +-+-+ + +
| | | |         | |   |     | |   | | | |
+ + +-+-+ + +-+ + + +-+-+-+-+ + + + +-+ +
|       | |   |   |     | | | | | |   | |
+-+ +-+-+-+-+ +-+-+-+-+-+ + + + +-+-+ +-+
|         | |     | | |         | |     |
+ +-+ + + + +-+-+-+ + +-+-+-+ + + +-+ +-+
| | | | |   | |     | |   | | | |       |
+ + + +-+ +-+ +-+-+ + +-+ + +-+ + +-+ + +
| | | | | |           |     |     |   | |
+ + +-+ +-+-+ + +-+ + + + + + + +-+-+-+-+
|   | |   |   | |   |   | |   | | |     |
+-+-+ + +-+ +-+ +-+-+ +-+-+ + +-+ + + + +
|   | |       | |   | |     |     | | | |
+ + + +-+-+-+-+-+-+ + + +-+-+-+ +-+ +-+ +
| |         |   | |   | |         | |   |
+ + + + +-+ +-+ + + + +-+ +-+ + +-+ +-+ +
| | | |   |   |   | |   | | | |   |   | |
+-+-+-+-+ +-+-+-+ + +-+-+ + +-+ +-+-+ +-+
| |     |   |     | |     |   |     | | |
+ + +-+ +-+ +-+-+ + +-+-+-+ +-+-+ +-+ + +
| |   | |       |     | | |           | |
+ + + +-+ +-+ + + + +-+ + + +-+-+ +-+-+ +
|   | |     | |   |       | |   |   |   |
+-+ +-+-+ + +-+ +-+ +-+ +-+ +-+ + + +-+ +
|         | | | | |   |   | |     | |   |
+-+ +-+ +-+-+ +-+ +-+-+ +-+ +-+-+ + + +-+
| | |     |   | | |   | | |     | | | | |
+ +-+-+-+-+ +-+ + + +-+-+ +-+ + +-+-+ + +
|         | |         |   |   | | |     |
+ +-+-+-+ + +-+-+ +-+ + +-+-+ + + + +-+-+
| | | |     |     |     | |   |   |   | |
+ + + +-+-+ +-+ +-+ +-+-+ + +-+ + + +-+ +
|       | |   |   | | |   | | | |   |   |
+ +-+-+-+ + +-+ +-+-+ + +-+ + + +-+ + + +
|   | | |                   | | |   | | |
+-+ + + +-+-+-+-+-+-+-+-+ + + +-+-+ + +-+
|   |   | |   |     | |   | | |   | |   |
+-+-+ + + +-+ +-+ +-+ + +-+-+ + +-+ + +-+
| |   |       |       |   |   |         |
+ +-+-+-+-+-+ +-+-+ + + +-+-+ + +-+-+-+ +
|   |       |   |   |   |     |   | |   |
+-+ +-+-+ +-+-+ + + +-+-+-+-+ + +-+ + +-+
|     |           | |   |       | | |   |
+ +-+-+ + + + +-+-+-+-+ +-+ +-+-+ + +-+ +
|   |   | | |   | | |   |   |       |   |
+ +-+ +-+ +-+ +-+ + + + +-+ + +-+ + +-+ +
|       | |     | | | |   |   |   | | | |
+-+-+ + +-+ +-+-+ + +-+ +-+ + +-+-+-+ + +
|     |   | |   |       |   | |       | |
+-+-+ +-+-+-+-+ + +-+-+ +-+ + + + +-+ +-+
|       | |     | |         |   | |     |
+ +-+-+-+ + + +-+ +-+-+ + + +-+ +-+-+-+ +
|       |   |       |   | | |       |   |
+-+-+-+-+-+-+ +-+-+-+-+-+-+-+-+-+-+-+-+-+
             V
