   V
+-+ +-+-+-+-+-+-+-+-+-+-+-+-+-+-+-+-+-+-+-+-+-+-+
|                   | |     |         |   | |   |
+-+-+ +-+-+ +-+-+ + + + +-+ +-+ + +-+ + +-+ + +-+
| |   |   |   |   |   | |   |   |   |   | |     |
+ + +-+-+ + +-+-+-+ +-+ + + + +-+ +-+-+-+ +-+ + +
| | |   |       |   |   | | |   | |       |   | |
+ +-+-+ + +-+ +-+-+-+-+-+ +-+ + +-+-+ +-+-+-+-+ +
| |     | |                   | |       |       |
+ + + +-+-+ +-+-+-+-+ +-+-+ +-+ + + +-+-+-+-+ +-+
|   |       | | |   | |     |   | | | |   |   | |
+ +-+ +-+-+ + + +-+ + +-+ +-+ +-+-+ + + +-+ + + +
| |   | |       | |     | | | |             |   |
+-+-+ + +-+ + +-+ + +-+-+-+ + + +-+-+ +-+ +-+ +-+
| |   |     | |   |   |       |   | | |     |   |
+ + + + +-+ + +-+ + +-+-+-+ +-+ +-+ +-+-+ +-+-+-+
|   | | |   | | |       |   | |   | | | | |     |
+-+ + +-+-+-+-+ + +-+ + +-+ + + +-+ + + + +-+-+ +
|   | |   | |   | |   | |   |     | | | | |     |
+-+-+-+ +-+ +-+ + + +-+-+ + + +-+-+ + + +-+-+ + +
|     |   | |   | | | | | | |     |     |     | |
+-+-+ + +-+ + +-+ +-+ + +-+-+ +-+ +-+ + + +-+ + +
| |         | |     |         | | |   | | | | | |
+ +-+-+ +-+-+ + + +-+-+-+ + +-+ + +-+ +-+-+ + +-+
|       |       |     |   | |   |   |           |
+-+-+ +-+ +-+ + +-+-+-+ + + +-+ +-+-+-+-+-+-+ +-+
|   | |   |   | | |   | | | |         | |       |
+ +-+ +-+ +-+ +-+ +-+ +-+-+ + +-+-+-+ + + + + +-+
|         | |     |     | |     | | | | | | |   |
+-+-+-+-+ + +-+ +-+ +-+-+ + +-+-+ + +-+ + +-+-+ +
| |   |       |     |   |                   | | |
+ + + + +-+-+-+ +-+-+-+ + +-+-+-+ + +-+-+ + + + +
|   |   |       |       | |   |   | | |   | |   |
+ +-+-+ +-+-+ + +-+ +-+ +-+ +-+-+ + + + +-+-+-+-+
| |   |   | | | |   |   | |     | | |     | |   |
+-+-+ + +-+ +-+ +-+ + + + +-+-+ + + +-+ +-+ + +-+
|             | | | | |   |       | |   |       |
+-+ + +-+-+-+-+ + +-+-+-+ + +-+ +-+-+ + +-+ +-+-+
|   |   | |         |   |     |   |   | |     | |
+-+ + +-+ +-+-+-+ +-+-+ + +-+-+-+-+-+-+-+-+-+ + +
|   | | |     |           |   | | | | |   |     |
+-+ +-+ + +-+-+-+-+-+ +-+-+ +-+ + + + + +-+ +-+-+
|     | |   | | |         |   | |     | |     | |
+-+-+-+ + +-+ + +-+-+ +-+-+-+ + + +-+ + +-+-+ + +
|           | |     |     | |     | |           |
+ + +-+ +-+ + + + +-+ +-+-+ +-+-+ + +-+-+ +-+ +-+
| |   | |       |   | |   |       | |       |   |
+ +-+-+-+ +-+ +-+-+-+ + +-+-+-+-+-+ +-+ + +-+ +-+
|   |   |   |       |   |   |   | |     | |   | |
+ +-+ +-+ +-+ +-+ +-+ +-+ + + + + + + +-+ +-+-+ +
|   | | |   |   |   |     | | |   | |   |   |   |
+-+ + + +-+-+ + + +-+-+ + +-+-+ +-+ + +-+-+ + +-+
|   | | |     | |     | |   | | |   |     |     |
+ +-+ + + +-+-+-+-+ + + + +-+ + +-+-+-+ +-+-+ + +
| |         |       | | | |   | |         |   | |
+ +-+ +-+-+-+-+ + + + + +-+-+ + +-+-+ +-+-+-+-+ +
| |   |         | | |   | |             | |   | |
+ + +-+-+ +-+ +-+-+ +-+ + + + +-+-+-+-+ + + +-+-+
| |     | |   | |   |       | |     |     | |   |
+-+ +-+-+ +-+-+ +-+ +-+-+ +-+-+-+ +-+ + + + +-+ +
|       | |     |     | |     |     | | | |     |
+-+-+-+-+-+ +-+ + + + + +-+-+ +-+-+ +-+ +-+ +-+-+
|   |   | |   | | | | |   | |   |   |           |
+ + + + + +-+ +-+ +-+-+-+ + + + + + +-+ +-+-+-+ +
| |   |   |   |       |   |   |   | | | |   |   |
+ + + + +-+ +-+-+-+ +-+ +-+-+ +-+ +-+ + +-+ + + +
| | | |     | |   |       |   |   |       | | | |
+ + + + + + + + + + +-+-+-+ +-+ +-+ +-+ +-+ +-+ +
| | | | | |     |     |     |     |   |     |   |
+-+-+-+-+-+-+-+-+ +-+-+-+-+-+-+-+-+-+-+-+-+-+-+-+
                 V
