2412
24 34
2 9
11,2,1,3,3,1,3,3,1,5,13,9,3,5,11,1,1,3,5,9,7,13,9,7
13,9,6,11,5,8,7,11,6,8,6,12,9,4,9,6,8,7,10,6,13,10,0,5
12,14,11,5,8,2,1,7,11,6,11,6,12,14,8,5,14,11,1,3,6,11,6,12
12,9,1,6,14,9,2,3,3,3,1,3,2,1,6,12,9,1,2,7,11,3,1,6
8,6,8,3,3,4,13,13,11,5,12,11,1,6,9,6,14,12,13,9,7,9,4,13
14,11,4,13,11,0,0,6,13,8,2,7,14,13,12,9,3,2,0,2,1,6,8,6
13,9,4,8,3,4,12,11,4,8,7,11,3,0,6,8,7,13,14,11,0,7,10,7
10,4,12,14,11,6,14,13,8,2,1,5,11,4,13,8,7,12,13,13,12,11,3,5
11,6,14,9,7,13,11,4,12,9,6,14,9,4,8,2,7,12,12,12,14,11,1,4
11,3,5,8,7,12,9,6,12,14,13,13,14,14,8,3,5,10,0,4,9,3,4,12
13,11,2,0,3,6,12,9,0,7,10,2,1,1,6,13,12,11,4,14,14,13,12,14
10,3,1,6,9,3,0,4,10,3,7,9,4,12,11,4,10,7,10,3,3,2,0,7
9,7,12,11,4,11,4,14,13,11,5,14,14,12,9,2,3,3,5,13,9,1,0,7
10,3,2,3,4,13,10,1,6,9,2,7,13,8,2,7,13,13,14,12,12,14,10,5
13,9,5,9,2,2,7,8,3,6,11,5,8,2,3,3,0,0,3,2,0,5,13,12
8,6,10,4,11,3,1,4,11,1,3,4,14,9,7,11,4,12,13,9,6,14,10,6
14,11,5,8,7,13,14,12,11,4,9,4,13,10,3,5,12,12,10,0,7,13,9,7
11,1,0,2,3,2,7,12,13,14,14,10,4,9,3,0,6,14,9,4,11,0,2,7
11,4,8,7,13,11,3,2,0,7,11,5,8,2,7,10,7,11,6,14,11,2,5,13
11,4,14,13,8,3,7,11,2,3,1,2,6,9,7,13,13,13,13,9,7,9,2,6
11,2,7,12,8,7,13,13,11,3,0,3,7,10,5,12,8,2,4,12,11,2,5,13
9,1,3,0,2,5,12,8,1,7,8,3,7,13,10,2,4,13,10,2,1,3,0,6
12,10,7,14,9,2,0,6,10,7,12,9,7,10,3,3,6,12,11,1,0,7,8,7
8,7,9,7,8,7,8,3,1,7,8,6,9,5,9,5,13,8,1,6,12,11,6,13
10,5,12,13,10,7,8,5,8,7,10,1,4,14,14,8,6,12,8,7,10,5,9,6
9,6,12,12,9,3,6,14,10,1,5,12,8,7,13,12,11,6,10,1,7,10,0,5
12,11,0,2,2,7,11,1,1,4,12,12,14,11,4,12,11,3,1,2,7,11,6,12
12,9,6,11,1,3,1,6,14,12,10,4,13,9,0,2,3,3,2,5,13,9,7,14
14,8,3,7,12,11,6,13,11,4,11,2,0,6,14,11,1,7,9,0,4,12,11,5
11,2,3,7,14,9,3,4,9,0,5,13,10,3,5,11,2,5,14,12,14,8,3,6
9,5,9,5,13,10,5,14,12,14,14,10,5,13,8,5,9,4,11,0,3,2,3,5
12,8,4,8,6,9,6,11,2,1,7,9,6,10,4,10,4,14,13,12,11,5,9,4
12,12,12,8,1,4,13,9,5,8,3,2,7,9,6,9,6,9,2,0,7,12,14,12
14,14,14,14,14,10,2,6,8,2,7,11,3,6,11,2,7,10,7,10,3,6,11,6
