                                           V
+-+-+-+-+-+-+-+-+-+-+-+-+-+-+-+-+-+-+-+-+-+ +-+-+-+-+-+-+-+-+-+-+-+-+-+-+-+-+-+-+-+-+
|       | | |   |   |   |       |   |   | |       |   | | |     |     |       |     |
+-+ +-+ + + + +-+ +-+ +-+ + +-+ + + + +-+ +-+ +-+-+ +-+ + + + +-+-+ +-+-+-+-+ +-+ +-+
|     |   | |     |   |   | |   | |     |       |           |   |       |   | | |   |
+ +-+ + +-+ +-+ +-+ +-+-+ +-+-+ + + +-+ +-+-+ +-+ +-+-+ +-+-+ + +-+ + +-+-+ + + +-+ +
|   | |   |   |   | |       | | | | |   |         | | | |   | |     |     |   |   | |
+-+ + +-+-+ +-+ + + + +-+-+-+ +-+ + +-+ + + +-+-+-+ + + +-+ +-+ +-+-+ +-+ + + + + + +
| | |     |   | |     |   |   |   | | |   | |         |       | |   | | |   | | | | |
+ +-+ +-+ +-+ + + +-+-+ +-+-+ +-+-+ + +-+-+ +-+ +-+-+-+-+-+-+-+ +-+ + + +-+ + + +-+ +
| |   |   |     |               |   |     | |   | | | | |   | |     |     | |       |
+ +-+-+ + + +-+-+ + +-+ + + +-+-+-+-+ +-+ + + +-+ + + + +-+ + +-+ +-+-+-+-+ +-+-+ + +
|     | |   | |   |   | | |   | | |   | | | |     |   | | | |       | | |     |   | |
+ + +-+ +-+-+ +-+ + + +-+-+-+ + + +-+-+ + + + +-+ +-+ + + + +-+-+ + + + + +-+-+ +-+ +
| |       |       | |   |     | | |   | |   | | |   | | | |   | | | |   | |   | |   |
+-+ + +-+ +-+-+ +-+-+-+-+-+ + + + +-+ + + +-+ + + +-+ + + +-+ + +-+-+-+ + +-+ + +-+ +
| | | |   |   |         | | | |         | |   |   |     | |     |     |   | |   |   |
+ +-+-+-+ +-+ +-+ +-+-+ + +-+ +-+-+-+-+ + +-+-+-+ +-+ +-+ + +-+-+ + + +-+-+ +-+-+ + +
|   |   | |   | | |   | |   | |     |       | |   | |       | |   | |   | | |   | | |
+ +-+ + + +-+ + + + +-+-+ + +-+-+-+ + +-+-+ + +-+ + + +-+-+ + + +-+ +-+ + + + +-+-+ +
|     | | | | | |     | | | |     | |   |   | | |     | |     | |   |     |   | | | |
+ + + + +-+ + + +-+ + + +-+ +-+-+ + +-+-+ + + + + +-+-+ + +-+ + + +-+-+ +-+ + + + +-+
| | | | |     | |   |     |     |       | | |   |     |     | | |   | |     |     | |
+-+ +-+-+ + +-+ + +-+ + +-+-+ + + +-+-+-+-+ + + +-+-+ +-+-+-+-+-+-+ + +-+ + + +-+ + +
|     |   | | |   | | | |   | |   | |         | |       |     | |     | | | | |   | |
+-+ + +-+ +-+ + +-+ + +-+ +-+-+-+ + +-+ +-+-+-+-+ +-+-+ +-+ + + + +-+ + +-+-+ + +-+ +
|   |     |     | |       | | |   | | | | |         | |     |   |   | | | |   |     |
+ + +-+ +-+-+-+-+ + +-+-+ + + + +-+ + + + +-+-+-+ +-+ +-+-+ +-+-+ + +-+ + +-+-+ +-+ +
| | |         |   |   |       | |         |   |   | |     |       |   | |   |   |   |
+-+-+-+ +-+ + + + +-+-+ +-+-+ + + +-+ +-+-+ +-+-+ + +-+-+ + +-+-+-+ + + +-+ + +-+-+ +
|       |   |   |   | |   | |     |         |           |     |   | |   |   |   |   |
+ +-+-+-+ + +-+-+-+-+ + + + +-+-+-+ +-+-+-+ + + + + +-+-+-+ +-+ +-+ +-+-+ + + +-+-+-+
|     | | |         | | |       | |     | |   | | |   |   |     |     | | | |   |   |
+-+-+ + +-+ +-+-+-+-+ +-+ +-+-+ + + +-+-+ +-+-+ +-+ + +-+ + +-+ + +-+-+ +-+ +-+ + + +
| |   |   |           |     |     |       | |   |   | |   |   | |     |       |   | |
+ +-+ + +-+ +-+ +-+-+-+ + +-+ +-+-+-+ +-+ + +-+-+ + +-+-+ +-+ +-+ + +-+-+-+ +-+-+-+-+
| | | |   | | |       | | |   | |       |     | | |   | |     | | |     | |     |   |
+ + + +-+ +-+ +-+-+-+ +-+-+ +-+ +-+-+ +-+ + +-+ +-+-+ + +-+-+-+ +-+ +-+-+ + + + + +-+
|         | |               |       | | | |       | |   |     |       |     | |     |
+-+-+ +-+-+ +-+-+ +-+ +-+-+-+ +-+-+ +-+ +-+-+-+ +-+ + +-+-+ + + + + + + +-+-+-+ + +-+
|   | |         |   |     | |   | | |         | |           | | | | |       | | |   |
+ +-+ +-+-+-+-+ + +-+-+-+-+ +-+ + +-+-+ + +-+-+-+ +-+-+ +-+ +-+-+ +-+-+-+-+-+ + +-+ +
|   | |             |   | |       | |   |       | |       | |   | |     |   |     | |
+-+ +-+ +-+-+-+-+ +-+ +-+ + + +-+ + +-+-+ + +-+-+-+-+-+-+ + +-+ + +-+ + + + +-+-+-+-+
|   |   |               |   |   | |     | |   | |   | | | | | |       |   | |       |
+ +-+-+ + +-+-+ + +-+ +-+ +-+ +-+-+-+ +-+ +-+ + + +-+ + +-+-+ +-+ +-+-+-+ + +-+ + +-+
|     | |     | | |       |       |     | |       |   |       |     | | | | |   |   |
+ + +-+ +-+-+-+ +-+ +-+-+ + +-+-+-+-+-+ + +-+-+-+ + + + +-+-+ +-+ +-+ + + +-+ +-+-+ +
| |   |   |       |     | | |       |   | |     |   | | |     |     |   |   |   |   |
+ +-+-+ + +-+-+-+-+ +-+-+-+ + +-+-+ + + +-+-+ +-+ + +-+ +-+-+-+ +-+ + + +-+ + +-+ +-+
| | |   |     |   |   |   | | |   | | |   |     | |       | |     | | | |       | | |
+ + +-+-+-+-+-+ +-+ + + +-+ + + +-+ +-+ +-+-+-+ +-+-+ +-+ + +-+-+-+-+ +-+-+ + +-+-+ +
|     |   | |     | |   | |       |   | | |     |     |   | |   |           |   |   |
+-+ +-+ + + +-+ + +-+-+ + +-+-+ + +-+-+ + +-+-+ + + + +-+ + +-+ +-+ + +-+-+ +-+-+ + +
| |     | | |   |   |       |   |   |   |       | | | |     | |   | |   |     |   | |
+ + +-+ + + +-+ +-+ +-+-+-+-+ + +-+-+ + + +-+ +-+-+-+ +-+-+-+ + + + + +-+-+ +-+-+ +-+
|   |   |   |   |   | | |     |   |   | | |     |       |   | | |   | |     |     | |
+ + + + + +-+ + +-+ + + +-+ + +-+-+-+ +-+-+-+ +-+ +-+ +-+ + + +-+-+-+-+ +-+-+ +-+-+ +
| | | | | |   |   | |   |   | |     |       |     |       |   |     | |             |
+ + +-+ +-+-+-+ +-+-+-+ + + +-+-+ +-+ + + +-+-+ + + +-+-+-+ +-+-+-+ + + +-+ +-+-+-+-+
| |   | |     | |         |         | | |   |   | |       |   | |       |   |   |   |
+ +-+ + +-+ +-+ +-+ +-+ +-+-+ + +-+ + + +-+-+-+ +-+-+-+-+ + +-+ + +-+-+ +-+ + +-+ +-+
| |   |   |           | |   | | |     | | |           |   |   |     | |   |         |
+ +-+-+ + + +-+-+-+-+ +-+ +-+ + +-+-+-+-+ + + +-+ +-+ +-+-+ +-+ +-+-+ + +-+ +-+-+-+-+
| |     |       | |   |   | | |             | | | |   |   |   |   |     |     |   | |
+-+ +-+-+-+-+ + + +-+ +-+ + + +-+-+ +-+-+ +-+-+ +-+-+ + +-+-+ +-+ + +-+-+-+-+ +-+ + +
|   |     |   | |         |   |   |   |   |         | |         | | | |             |
+-+ + +-+-+-+-+ +-+-+-+-+ +-+ + + +-+-+-+-+ +-+-+ + + +-+ +-+-+ +-+-+ +-+ + +-+-+ +-+
|   |   |   | | |           |   | | | | |   |     |   | | |     |     |   |   | |   |
+ +-+ +-+ +-+ +-+ + +-+-+-+-+-+-+ + + + +-+-+-+-+ +-+-+ +-+-+-+-+-+ + +-+-+-+-+ + + +
| |       | |     | |           |       |     |           |   |     | |     | |   | |
+-+ + +-+ + + +-+-+ + +-+-+ + +-+ +-+ + + +-+ +-+ +-+ + + +-+ +-+ + + + +-+ + +-+-+ +
| | | |         | | |     | |   | |   | | |     | | | | | | | |   | | | |     | | | |
+ + +-+ + + +-+-+ +-+ +-+-+ +-+-+-+-+-+ + +-+ + + + +-+ +-+ + +-+ + +-+ + +-+-+ + + +
|     | | | |   |       |   |     |     | |   |     |     |       |     |   | |   | |
+-+ +-+-+ + + +-+-+-+-+-+ + +-+ +-+-+ +-+-+ +-+-+ +-+ +-+-+-+ +-+-+ +-+-+-+-+ +-+ + +
|     |   |           |   |       |     | |     | |   |   |   | |       | | | |   | |
+-+ +-+-+-+ + +-+ +-+ + +-+-+-+-+-+-+-+ + +-+-+-+-+ + + + + + + +-+ +-+-+ + + + +-+-+
|   |     | | |   | |   |       | |     | |     | | | | | | |   |   | | |           |
+-+ + +-+ +-+-+-+-+ + + +-+ + +-+ +-+ +-+ + +-+-+ + +-+-+ +-+-+-+-+ + + +-+ +-+-+ + +
| | | | |   |     |   | |   | |     | | |     |     |         | | | |     | |     | |
+ + + + +-+-+ + + + + + + +-+-+-+ +-+-+ + +-+ +-+ + + +-+-+ + + + + +-+ +-+-+ +-+ +-+
|   |   |     | |   | | | | |     |         |   | |   |     |   |     | |   |   | | |
+-+-+ +-+-+-+-+ +-+-+-+-+ + +-+ + +-+ + + + +-+ +-+-+ +-+ +-+-+ +-+ +-+ + + +-+ +-+ +
|   | |         |     |     | | | |   | | | | |   | | |   |           |   | | | |   |
+-+ + +-+-+ +-+ + + +-+-+-+ + +-+ +-+-+ +-+ + +-+-+ + +-+-+-+-+-+ +-+ + + +-+ + + +-+
|           |   | |         |       | |   |     | | | | |           | | | |   |   | |
+-+-+ +-+ +-+-+ + +-+-+ + +-+ + + + + +-+ +-+-+ + + + + +-+-+ +-+ +-+ +-+ +-+ + +-+ +
|       | |         | | | |   | | | | | |   | |   |     |   | |   |   | |           |
+-+ +-+ +-+-+ + + +-+ +-+-+ + +-+ + + + + +-+ + +-+-+ + + +-+-+-+ +-+ + + +-+-+ +-+ +
|   | |   |   | | |     |   | |   |       | |   | | | | |         |   |   |     | | |
+-+-+ +-+ +-+-+ + + +-+ +-+-+ + +-+-+ +-+-+ +-+-+ + +-+-+-+-+-+-+ +-+ +-+ +-+ +-+ + +
|             | | | |   |     | |   |   | |   |         |     | |   |   |   |   | | |
+-+ +-+-+ +-+ +-+ + + + +-+ + +-+ +-+-+ + + +-+ +-+-+ +-+ +-+-+ +-+-+ + + + +-+ + +-+
| |     |   |   |   | | | | |     |   |   | |   | | |     |       | | | | | | | |   |
+ +-+-+ + +-+ + +-+ + + + + + + + +-+ +-+ + +-+-+ + +-+-+ + +-+-+ + + +-+ + + +-+-+ +
| | |   | |   | |   | | | | | | |   |       |         | |   |   |   | |   | |   |   |
+ + +-+-+-+-+ +-+-+ +-+ + +-+-+ + +-+-+-+-+-+ + +-+-+-+ +-+ + + +-+ + + +-+ + +-+ +-+
|       | |     |     |   |     | |   | |     |     |       | |       | |     |   | |
+ +-+ +-+ + +-+-+ + +-+ +-+-+ +-+-+ +-+ + + + +-+ +-+-+ +-+-+-+ +-+-+-+ +-+-+ + +-+ +
|   |     | |   | | |     |         |   | | | |     |     | |         |   |         |
+-+ + + + + + +-+-+-+-+ + +-+ +-+-+-+-+ + +-+-+-+ +-+ + +-+ + +-+-+ + + +-+ +-+ + +-+
|   | | | |       | | | | |   | |     |   | | | |   | | | |   |   | |   | |   | |   |
+-+-+ + +-+ +-+-+-+ + +-+ + + + +-+ +-+-+-+ + + + +-+-+-+ +-+ + +-+ +-+ + + +-+-+-+ +
| | | |   | |   |           |           | |       | | |   |   | |   |     |     | | |
+ + +-+ +-+ + +-+ +-+ + + +-+-+ +-+-+-+-+ +-+ +-+-+ + +-+ + + + + + +-+ +-+-+-+ + +-+
|   |     |     |   | | |   |               |     | | |     |   | |   |   |   | |   |
+ +-+ +-+-+-+ +-+-+-+-+-+-+-+ + +-+-+-+-+ +-+ +-+-+ + + +-+ + + + +-+ +-+-+ +-+ +-+ +
| |         |     | |   |   | | |   | | | |   |     | |   | | | |   | | | |   |     |
+ +-+-+ + +-+-+-+ + +-+ + + + +-+ +-+ + +-+-+ +-+ + + +-+-+ +-+-+-+-+-+ + +-+ + + + +
|       | | |     |     | | | |   |         |   | | |     | |     |     |       | | |
+ + +-+ +-+ + + +-+-+ +-+ + + +-+ +-+-+ + +-+-+ + +-+-+-+ + +-+-+ + +-+-+-+ +-+ + +-+
| | | |   | | | | | |   | |       | |   | |         |   |     | |       |     | |   |
+ +-+ + +-+ +-+ + + + +-+ +-+-+-+ + +-+ +-+-+ +-+-+ +-+ + + + + + +-+-+ + +-+-+-+-+ +
|   |   |   | | |     |     | | |           |   |         | | |   |   | |   | |   | |
+-+-+ + + +-+ +-+ +-+-+-+ + + + +-+-+-+-+ + +-+-+-+-+ +-+-+-+ + +-+ +-+-+ + + +-+ + +
| | | |     |   |   |     |     |   | | | |     |     |           |   |   | |       |
+ + +-+-+ +-+ +-+ +-+-+ +-+-+ + + +-+ + +-+ +-+ + + + + + +-+ +-+-+-+ + +-+ + +-+ +-+
|                         |   |   | |   | | |   | | | | |   | |     | |   | | |   | |
+ + + +-+-+-+ + +-+ +-+-+-+ + + + + + +-+ + +-+ +-+ + +-+ + +-+-+ + + + +-+ +-+ + + +
| | |       | | |     |     | | | |         |   |   | |   |   |   |     |   |   |   |
+-+-+-+-+-+-+-+-+-+-+-+-+-+-+-+-+-+-+-+-+-+-+-+ +-+-+-+-+-+-+-+-+-+-+-+-+-+-+-+-+-+-+
                                               V
