                                                                               V
+-+-+-+-+-+-+-+-+-+-+-+-+-+-+-+-+-+-+-+-+-+-+-+-+-+-+-+-+-+-+-+-+-+-+-+-+-+-+-+ +-+-+-+-+-+-+-+-+-+-+
| |   | | |     | | | | | | | |   | |   |         | | | |   |       |           |     |     |       |
+ + +-+ + +-+-+ + + + + + + + + + + +-+ + +-+-+-+ + + + +-+ +-+ + + +-+ + +-+-+-+ +-+-+-+ +-+ + + + +
| | | |       | |             | |           | |     |       |   | |   | | |   | | |     |   | | | | |
+ + + + + +-+ + + + + +-+ +-+ + +-+ + +-+-+ + +-+-+ +-+ +-+ + + +-+-+-+-+ +-+ + + +-+ +-+ +-+-+-+-+ +
|       | |   | | | |   | | | | | | | |           |   |   |   | |   | | |   |     |     | |   | |   |
+-+-+ + +-+-+-+ + + +-+-+-+ +-+ + + +-+-+ +-+-+-+-+ +-+-+ +-+-+-+ +-+ + + + +-+ +-+-+ +-+ +-+ + +-+ +
|     | | |   |   | | |   | |   | |   |     |     | |               |     |   |   | |   |     |     |
+ +-+-+ + + +-+ + + + + +-+ + +-+ + +-+ +-+ +-+-+ +-+ +-+ + + + +-+ +-+ +-+ + + +-+ + +-+ +-+-+ + + +
|   |     | |   | |   |     | |       |   | | |   |   |   | | | | |     |   |     | |   | |   | | | |
+-+ +-+ + + + +-+-+-+ +-+ +-+ + +-+-+ + +-+-+ +-+ +-+ +-+ +-+-+-+ +-+-+-+ + +-+-+-+ + + + + +-+-+ + +
| |   | |   |       |   | |   |   | | |     |   |       |         | | |   | |         | | | |   | | |
+ +-+-+-+-+ +-+ +-+-+ + + + + +-+ + +-+ +-+ +-+ + +-+-+-+-+-+-+-+ + + + +-+-+-+-+-+ +-+ + + + +-+ +-+
| | | | |     | |     |   | | |     |   | | |       |     |   |     |     |   |   | |         | |   |
+ + + + +-+ +-+ +-+-+-+ +-+ +-+ +-+-+ +-+ +-+ + +-+-+ +-+ +-+ + + +-+-+-+-+ + + +-+ +-+-+ + +-+ + + +
|   | |   |     |   |     |   |   | |     |   |         | |     |   |     | |     | |     |       | |
+-+ + + +-+-+-+-+ +-+ + + + + + + + +-+-+ +-+ + + +-+ + + + +-+-+-+ + +-+-+-+-+ +-+-+-+ + + + + + +-+
| |           |     | | | | | | | |   |       | |   | | | |     |     |   |             | | | | |   |
+ +-+-+ + + +-+ + +-+ +-+-+-+-+ + +-+ +-+ +-+-+-+-+-+-+ +-+-+-+-+ +-+-+ +-+-+ + +-+ +-+ +-+ + +-+-+ +
|       | |     |         |   | | |   |       |         |     |   | |         | |   |     | | |     |
+ + + +-+ +-+ +-+-+-+-+-+-+ +-+-+-+ +-+ +-+-+ + +-+ +-+-+ +-+ +-+-+ + +-+ +-+-+ +-+-+-+-+ +-+-+-+ +-+
| | |   | | |     |                   |     | | |   |   |   | |         |     |     | |   |     |   |
+ +-+ +-+ + +-+-+ + + + +-+-+-+-+-+-+-+-+ +-+-+-+-+ +-+ + +-+ +-+ +-+ +-+ + +-+-+ +-+ + +-+ +-+-+-+ +
| |   |   | |       | |     |       |         |       |     | | | |     | |   |       | |           |
+-+-+ +-+-+ +-+ + + + + +-+ +-+ +-+-+ +-+-+-+-+-+ +-+-+-+-+-+ + + +-+-+-+ +-+-+-+ +-+-+ +-+ + +-+-+-+
|     |       | | | | | |         | |     | |       | | | |     |   |   |     |   | | | | | |   |   |
+-+-+-+ +-+-+ + +-+ +-+-+ + +-+-+-+ + +-+ + + +-+ +-+ + + +-+-+ +-+ +-+ + + +-+-+-+ + +-+ +-+-+ + +-+
| | |   |         |   |   | | |         |   | | | | | |   | |   |       | |   | | |   |     |     | |
+ + +-+ +-+-+-+-+-+ +-+-+-+ + + +-+ +-+ +-+ +-+ +-+ + + + + + +-+ +-+ +-+-+ +-+ + +-+ + +-+ +-+-+ + +
|               | | |   |       |     | |     |         |   |   |   |     | |       |   |   |   |   |
+-+-+-+-+ +-+-+-+ +-+ +-+-+ +-+-+-+-+-+-+-+ + +-+ + +-+-+ +-+ +-+-+-+-+ +-+-+ + +-+ + + +-+ + +-+ + +
|   |     |   |     | | |         |       | | |   | | |     |       |   |   | | |     | |   | |   | |
+-+ + +-+-+ + + +-+-+ + + + +-+ +-+-+-+ +-+ +-+-+ + + + +-+-+-+-+-+ + + + +-+-+ + + +-+-+ + + + + +-+
| | | | |   |   |   |   | |   | |         |       |   | | |   |       | |   |   | |   |   | |   |   |
+ + + + +-+ +-+ +-+ +-+ + +-+-+-+-+ +-+-+ +-+-+-+-+-+-+-+ + + +-+ + + +-+ +-+ +-+-+-+ +-+ +-+-+ +-+-+
|   |       |   | | | |           | |     |   |     | | |   |   | | | |   |   | |   | |     |     | |
+-+ + +-+ +-+-+-+ + + +-+-+-+-+ + + +-+-+ + + +-+ +-+ + +-+ + +-+ +-+-+ + +-+ + + +-+-+-+-+-+ +-+-+ +
| | |   |         | |   |   |   |   |   |   | | | | |   |   | | |     | | |   | |   |     |     |   |
+ + + +-+-+ +-+-+-+ +-+ + + +-+-+-+-+ + +-+-+ + + + +-+ + +-+ + +-+ + +-+ + + + +-+ + +-+-+-+-+ + + +
| | |   |     |       |   | |   |   | |   |       | |   | | | | |   |       |         |         | | |
+ + + +-+-+ +-+-+-+ +-+ +-+ +-+ + +-+-+ + +-+-+-+-+ +-+ +-+ + + + +-+-+-+ + + + +-+-+-+-+ +-+-+-+ +-+
|     | | |   |     | | |   |       |   | |     | |         |         |   | | |   |         |       |
+ + +-+ + + + +-+-+ + +-+ +-+-+ +-+-+ +-+ + + + + + +-+-+ +-+-+-+-+-+ +-+-+-+-+ +-+-+-+-+ + + + + +-+
| |       | | | |     | |   | |       | |   | |     |   |     | | |       |           | | |   | |   |
+-+-+ + + + + + + +-+ + + + + +-+-+-+ + +-+ +-+-+-+ +-+ +-+ + + + +-+ +-+-+ +-+-+-+-+ + + +-+-+ +-+ +
| |   | | | | | | | |     | |     |   |     | |   |   |   | | |     |   | |       |   |   | |     | |
+ +-+ +-+-+ +-+ +-+ +-+ +-+-+-+-+ + +-+-+ +-+ + +-+ +-+-+ +-+-+-+-+ +-+ + + + +-+-+-+-+-+-+ +-+-+ +-+
|   | |               |       |     | | | | |   |     |     | |   | | | |   | |   | | |       | | | |
+ +-+ + +-+-+ +-+-+-+-+ +-+-+-+ +-+-+ + +-+ + +-+ +-+-+-+-+ + + + + + +-+ +-+-+ +-+ + +-+ +-+ + + + +
|   | | |   |       |                       |       | |       | |           | | |     |   |   |     |
+-+ +-+-+ + + +-+-+ +-+-+-+ +-+-+ +-+ +-+-+ +-+-+ + + + + +-+-+-+ +-+-+-+-+-+ + + + + + +-+ +-+-+ +-+
|   | |   |     |             |     |     |   | | | |   |   | |       |     |     | |     | |       |
+ + + +-+ +-+-+-+-+ +-+-+ + + +-+-+ + + +-+-+-+ + +-+ +-+ +-+ +-+-+ + +-+-+ + +-+ +-+ + + +-+ + +-+-+
| | | |   | | |   | |     | |   | | | | | | | |   |     |   |     | |       | |   | | | | |   | | | |
+ + + +-+-+ + +-+ + +-+-+-+ +-+-+ +-+ + + + + +-+ +-+-+-+ +-+ +-+-+ +-+ + +-+-+-+ + +-+ +-+ +-+ + + +
| | |   |       |     | | | | |   |   | | |   | |   |         | |     | |   |   | |   |       |   | |
+-+ + +-+ +-+-+-+-+-+-+ + + + +-+ + +-+-+ +-+ + +-+ + +-+ +-+ + +-+-+ +-+-+-+ +-+ +-+ +-+ + + +-+ + +
| |       |     | |     |     | |   |   |         | |   | |     | |   |     | |   |     | | | |   | |
+ + + +-+ +-+ +-+ +-+-+ + +-+ + +-+ + +-+ + +-+-+ + +-+ +-+-+-+ + + +-+-+-+ + +-+-+-+ +-+ +-+ +-+ + +
|   |   |       | |   |   |   |     | | | | |   | |     |   |   |       |   | |             | | |   |
+-+-+-+ +-+ + + + +-+ + +-+-+-+-+ + + + +-+ + +-+ +-+ +-+-+ +-+ + +-+-+ +-+ + +-+ +-+ +-+ + +-+ +-+ +
|   |     | | |     |     |   |   |       |     |   |   | |   |     | | | | |     | | |   |   |     |
+-+ + +-+ +-+ +-+-+ +-+-+ +-+ +-+-+-+-+-+ + +-+-+-+ +-+ + +-+ + +-+-+ +-+ + +-+-+ + + +-+ +-+-+-+ + +
|       |   | |   | | |   |   | | |       | |   |     |   |   |   | |     | |     | | |   |   | | | |
+ +-+-+ + +-+ + + +-+ + +-+ +-+ + + +-+-+ +-+-+ +-+-+ +-+ + + + + + + + +-+ +-+-+ + + + +-+ + + + +-+
| | |   |   |   |       |   |     | |       | |     |   |   | | |   | | |   |   | |   |     | | |   |
+ + + +-+-+-+ + +-+-+ +-+-+ +-+ + +-+-+-+ + + + +-+ + + + +-+-+ +-+ + + +-+ + +-+ +-+ + + +-+-+ + + +
| |       |   |     |         | |     |   | |   | |   |   |     |     |     |       | | | |     | | |
+ +-+-+ +-+ +-+ + +-+-+ + +-+-+ +-+-+ +-+ +-+ + + +-+-+ +-+-+-+ +-+-+ + + +-+-+-+ +-+-+ +-+ +-+ +-+-+
| |   | |     | | |     |     |   |       | | |   |     |     | |     | |       | |     |   |       |
+ +-+ +-+-+-+ +-+-+-+-+ +-+ +-+-+-+-+ + + + +-+-+-+ +-+-+-+ +-+-+ +-+-+-+ +-+ +-+-+-+-+ +-+ +-+ + + +
|     | |         |     |   | |     | | |       | |   |   |         |       |     | | | | | |   | | |
+ +-+ + + +-+ +-+-+ + +-+ + + +-+ + + +-+-+-+-+ + +-+ + + + + +-+-+-+-+-+ +-+-+ +-+ + +-+ + + + +-+ +
|   |   | |   | |   | |   |       | | | | |   |     | | | | |   |         |     |       |   | | | | |
+ + + + + + +-+ +-+-+-+-+-+ + +-+-+ + + + + + +-+ +-+-+-+ + +-+ + +-+ +-+ + +-+-+-+-+ + + + +-+ + +-+
| | | | | | |     | |     | | |     |     | | |         |     | |   | | | |     |   | | | | | |     |
+ + +-+-+-+ +-+ + + + +-+-+-+-+-+-+-+-+-+-+-+ + +-+ +-+-+ +-+ + +-+ +-+ + +-+-+ + + + +-+ +-+ + + + +
| |     | |   | |       |   | |   | |       |   | |     |   | |   |     | |       |       |     | | |
+-+-+ +-+ + +-+ +-+-+ + + + + + +-+ +-+ +-+-+-+ + +-+ + +-+-+-+-+-+-+-+ +-+ +-+-+ +-+-+ +-+-+-+-+-+-+
|         | |   |   | |   | |         |     | | |   | | | |   |     |     | |       | | |     |     |
+-+ + + +-+-+-+-+-+ +-+-+ +-+ +-+-+ +-+-+ +-+ + + +-+-+-+ + +-+-+ + +-+-+ + +-+ +-+ + +-+-+ + +-+ + +
|   | | |           |   |     |             |           |     |   |     | | |   |     | |   |   | | |
+-+ +-+ + +-+-+ + + + +-+-+-+ +-+ +-+-+ +-+ + + +-+-+ +-+ +-+-+-+ +-+-+-+-+-+-+-+-+-+ + + + +-+-+-+ +
|   |   | |     | |   | |     | |     | |   | |     |   |   |             |     |     |   |     | | |
+ +-+ +-+ + +-+-+ +-+-+ +-+ +-+ +-+-+ +-+ +-+-+-+-+ +-+-+ + +-+-+ +-+ +-+ +-+ +-+-+-+ + +-+-+ + + + +
|   | | | | |             | |     |   |     | |         | | |   |   |   | | | | |     | | |   | |   |
+-+-+-+ +-+ +-+-+ + + +-+-+ + +-+-+-+ +-+-+-+ + +-+-+-+-+-+ + +-+ + +-+ + + + + +-+-+-+ + + +-+ + + +
|   | |   |     | | | |   | | |     |       |           |   | |   |   | | |       |   | | | | |   | |
+ + + +-+ + +-+ +-+ +-+-+ + + + +-+-+-+-+-+ +-+-+-+ +-+ + + + +-+ +-+-+-+ + + + +-+ +-+ + +-+ +-+ +-+
| |         | | | | | | |   | | | | |     |         |   | |   |     | |   | | | | | |     | |       |
+-+ +-+ +-+ + + + + + + +-+ + + + + + + +-+ +-+-+-+ +-+ +-+ +-+ + +-+ + +-+ + +-+ + +-+ +-+ +-+ + +-+
| | |   | | |   |     |           |   |   |     |   | |     |   |   | |     |         |       | |   |
+ + +-+-+ +-+-+ +-+-+ + +-+-+-+ + + + +-+-+-+-+-+-+-+ + + +-+ +-+-+ + + +-+-+ + +-+-+ + +-+ + + + +-+
|           |     | | |   |     | | | |   |   |     | | | |       |   |     | |   |     | | | | |   |
+-+ +-+ + +-+-+ + + +-+ +-+-+ +-+-+ +-+ + +-+ + + + + + +-+ + +-+ +-+ +-+-+ +-+ +-+-+ + + +-+-+ +-+-+
|   |   | | |   |     | |   |           |     | | | |     | |   | | |     | | |     | | |         | |
+ +-+-+ +-+ + +-+ + +-+-+-+ + +-+ +-+-+ + +-+ + + +-+-+-+-+ +-+-+-+ + +-+-+ + + + + +-+ + +-+ +-+ + +
| |     |   |   | |     | |     | |   | |   |   |   |   | |   | |       |   |   | | | | |   | |   | |
+-+-+-+-+ + + + + +-+ +-+ + +-+-+-+ + +-+ +-+-+ + + + +-+ +-+ + +-+-+-+-+ + +-+ + +-+ +-+ +-+-+ + + +
|     | | | | | | |       | |       | |     | | | |       |   |       | | |   | |   | |     | | |   |
+ + + + +-+ +-+-+ +-+-+ +-+ + +-+-+ +-+-+ +-+ +-+ +-+ + +-+ + + + +-+-+ + + + + +-+ + +-+ + + + + +-+
| | | |     | | | |       | |   |         |     | |   | |   |   | | |     | | | | |   | | |   | |   |
+ + + + +-+-+ + +-+-+-+ +-+-+-+-+-+ +-+-+ +-+ + +-+-+ +-+-+-+ +-+-+ +-+-+-+-+-+ + + + + +-+-+-+-+ + +
| | |       |       |             | | | |     |   | | |     |       |   |     | |   |   |   |   | | |
+-+-+-+-+ +-+ +-+ + +-+-+-+-+-+ +-+-+ + + +-+ +-+ + +-+ +-+-+-+ +-+-+ + +-+-+ + +-+ +-+ + + + + +-+ +
|             | | | |   | | |       |     | | |   |     | | |   | | | | | |     |   | | | | | |     |
+ + +-+ + +-+-+ +-+ +-+ + + + +-+ +-+-+ + + +-+ +-+ +-+ + + +-+-+ + + +-+ + +-+ +-+ + + + +-+ +-+-+ +
| |   | | |   |   | |   | | |   |       |     | | |   |                       |   | |     | | |   | |
+-+ +-+ +-+ +-+-+ + + +-+ + +-+-+-+ +-+ + +-+ +-+ +-+-+-+ +-+-+-+ + +-+ + + + + +-+ +-+-+ + +-+-+ + +
| |   |   |     |     |   |   |       | | | | |     | |   |     | |   | | | | | |       |   |   | | |
+ + + +-+ +-+-+ + +-+ +-+ + +-+ + + + +-+ + +-+ + +-+ +-+ + +-+ +-+-+-+ +-+-+ +-+ +-+-+ +-+ + +-+ +-+
|   | |         |   | |     |   | | |   |     | |   |       |   |   | |   | | |   |   | | | | |   | |
+ +-+-+-+ +-+ + + +-+ + + +-+-+ +-+-+-+-+ +-+ + +-+-+-+ + + +-+ +-+ + +-+ + +-+ + + +-+ + +-+ + + + +
|     |   |   | |   | | |         |     |   |           | |   | |       |   | | | |       |     |   |
+ +-+-+-+-+ + +-+-+ +-+ + + + +-+ +-+ +-+-+-+-+-+-+-+-+-+ +-+-+ +-+ +-+ + + + +-+-+ +-+-+ + + + +-+ +
|     | |   | |     |   | | | |     | |         | |   | |     | |   | |   |   | |     |     | | |   |
+-+ + + + +-+ +-+ + + + +-+-+-+ +-+ + +-+ +-+ + + + + + +-+ +-+ +-+-+ +-+ +-+ + + +-+-+-+ +-+ +-+-+ +
|   |   | | | |   | | |     |     |   |   | | |     |   |     |   |     |   | | | |     | |   |   | |
+ +-+ +-+ + +-+ + +-+-+ +-+-+ + +-+-+-+-+-+ +-+ +-+-+-+-+-+ + +-+-+-+-+ +-+-+ + +-+ +-+ + + +-+-+ + +
| |   |     | | |   |     |   |       |   |   | |   |     | | |     | |     |   | | |     | |   | | |
+-+-+-+ +-+ + +-+ + +-+-+-+-+ + +-+ + +-+ + +-+ + + +-+ + +-+ + + +-+ +-+ + +-+-+ +-+ +-+-+-+ +-+ + +
|       | | |     |           | |   | |   |       | | | |     | | | |   | |     | |       | |       |
+-+ +-+-+ +-+-+-+-+-+-+ + + +-+-+-+-+ + + + +-+-+-+ + +-+ +-+ +-+ + + +-+ +-+ + + +-+-+-+ + + +-+-+ +
|       |   | |   |   | | | | |   |   | | |     |       | | |       |   |   | |     |   | | |   |   |
+-+-+-+-+ +-+ + + +-+ + +-+ + +-+ +-+ +-+ +-+ +-+ +-+ +-+ + +-+ +-+ +-+ + + +-+ + + + +-+-+ +-+ + +-+
| |   | |       |   |   |     | |         |     | |   |   |     |       | | |   | | | | |       |   |
+ +-+ + +-+ +-+ +-+-+ +-+-+ + + +-+-+ +-+ + + +-+-+-+-+-+ + +-+-+ + +-+ +-+-+-+-+ +-+ + +-+ +-+ +-+-+
|       |     | | |     |   |       | | |   |   | |   | | | |     |   | |     |   |     | | |       |
+ +-+-+-+ + +-+ + + +-+-+-+-+-+ +-+ +-+ +-+ +-+ + + + + + +-+ +-+-+-+-+ +-+ +-+ + + +-+-+ + + + +-+ +
|     |   |   |     | | |   | |   | |     |   | |   | |   |   |                 |     |   | | |   | |
+ +-+ + + +-+-+ +-+-+ + + +-+ +-+ + +-+-+ +-+ +-+-+ +-+ + + + +-+-+-+-+ + +-+-+-+-+-+-+ + +-+-+-+ +-+
|   |   |     | |   | | | |     | |     | |           | | | |   |   |   | |   |   |     | |   |   | |
+ +-+ +-+ + +-+ +-+ + + + + +-+ + + + +-+ + +-+-+-+-+ +-+-+-+ + + +-+ + + +-+ +-+ + +-+ +-+-+ + + + +
| |     | | | | |   | |       | | | | |   | |         | |     | |   | | | | | |     |       |   |   |
+-+ +-+-+-+ + +-+ + + +-+-+ +-+-+ +-+-+-+ +-+ + +-+-+-+ + + +-+ + +-+ + +-+ + +-+ + +-+-+ + + +-+-+ +
|         | | | | |   |     |   | |   |   | | | |       | | |   |     |   |   |   | | |   |     | | |
+-+-+-+-+-+-+ + +-+ +-+-+ + +-+ + +-+ +-+ + +-+-+ +-+ +-+-+ +-+ +-+ + + + + + + + +-+ +-+-+-+ +-+ +-+
| |     | |           |   |             |     |   | | | | |   | |   | | | | | | | |   | | | |       |
+ +-+ +-+ + + + +-+-+-+ +-+-+-+ +-+-+-+-+-+-+ +-+ + +-+ + +-+ +-+ +-+ +-+ + + +-+ + +-+ + + +-+ +-+ +
| | |   | | | |   |           | | | |   |             |     | | | |   |     | | |     |     |     | |
+ + +-+ + + +-+-+-+-+ + +-+-+-+-+ + +-+ +-+-+ + +-+ +-+ +-+ + + +-+-+ +-+ +-+-+ +-+ +-+ +-+ +-+ + +-+
|           |       | |       |     |     |   | | |     |       |   | |       |   |   | | | |   |   |
+ + +-+ +-+ + +-+-+-+-+ + +-+ +-+-+ + +-+-+ + + + +-+-+-+ + + + + + +-+-+-+-+ + +-+ + +-+ + +-+-+ + +
| |   | | | | |         |   | |   |     |   | |   |   | | | | |   |     |   | |   | | |   | |     | |
+-+-+-+-+ + + +-+-+ +-+-+ + + + +-+-+-+ + +-+ +-+-+-+ + + +-+-+ + +-+-+ + +-+-+-+ +-+-+ +-+ +-+ + +-+
| |   |         |     |   | | |   | | |   |       | |       |   | | |             |   | |   | | |   |
+ + +-+-+-+ + + +-+ +-+ + +-+-+ +-+ + + +-+-+ +-+-+ +-+-+ +-+-+-+ + +-+ +-+-+-+ + +-+ + +-+ + + + +-+
|     | | | | |     |   | |     |     | | |   |         | |         |     |   | | | |           | | |
+ + + + + +-+ +-+-+-+-+ + +-+ + +-+ + +-+ +-+ + +-+ +-+-+ + +-+ + + +-+ + + +-+-+ + + +-+-+-+-+ + + +
| | |         |         | |   |     |             | |     |   | | | |   |     |     |   |       |   |
+-+-+-+ +-+-+-+-+-+-+-+-+-+-+-+-+-+-+-+-+-+-+-+-+-+-+-+-+-+-+-+-+-+-+-+-+-+-+-+-+-+-+-+-+-+-+-+-+-+-+
       V
