         V
+-+-+-+-+ +
|   | |   |
+-+ + +-+ +
|     |   |
+ +-+ + +-+
|   | |   |
+ +-+ + + +
| |     | |
+ +-+-+ +-+
|   |     |
+ +-+-+-+-+
 V
